111111111111111111111111111111111111111
100000000000000000000000000000000000001
12000000E000000000000000000000000000001
100000000000020000000000000002000000001
100000000000000000000000000000000000001
100000000000000001000000000000000000001
1000000200000000000000000000C0000000001
100000000000000000000000000000000C00001
100000000000000000000000000000000000001
100000000000020000020000000020000000001
100000000000000000000200000000000000001
10000000020P0000000000000C0000000000001
111111111111111111111111111111111111111
